********************************************************************************
*##############################################################################*
*##############################################################################*
*##############################################################################*
*##############################################################################*
*##############################################################################*
*##############################################################################*
*##############################################################################*
*##############################################################################*
*##############################################################################*
**#############################################################################*
*##############################################################################*
*##############################################################################*
*##############################################################################*
*##############################################################################*
*##############################################################################*
*##############################################################################*
*##############################################################################*
*###########################################################**********#########*
*#############################**********####################**********#########*
*#############################**********#######################################*
*#############################**********###################################**##*
*#############################**********###################################**##*
*#############################**********#######################################*
*#############################**********#######################################*
*#############################**********#############################*#########*
*#############################**********#######################################*
*#############################**********#######################################*
*##############################################################################*
*############################################################################***
*############################################################################***
*#######***##################################################################***
*#######***##################################################################***
*#######***##################################################################***
*###########################****#############################################***
*###########################****###############################################*
*###########################****###############################################*
*#####################**####****###############################################*
*#####################**###################################################*###*
********************************************************************************
